Census Tract,County,Total Population,Occupied housing units,Occupied housing units: Owner Occupied,Occupied housing units: Renter occupied
"Census Tract 9900, Alameda County, California",Alameda,0,0,0,0
"Census Tract 4432, Alameda County, California",Alameda,3704,1171,1131,40
"Census Tract 4511.02, Alameda County, California",Alameda,4011,1322,1268,54
"Census Tract 4420, Alameda County, California",Alameda,3212,997,926,71
"Census Tract 4261, Alameda County, California",Alameda,5922,2116,1958,158
"Census Tract 4351.03, Alameda County, California",Alameda,6403,2045,1885,160
"Census Tract 4403.32, Alameda County, California",Alameda,3310,866,792,74
"Census Tract 4304, Alameda County, California",Alameda,2046,747,682,65
"Census Tract 4046, Alameda County, California",Alameda,4353,1800,1642,158
"Census Tract 4431.03, Alameda County, California",Alameda,4029,1166,1062,104
"Census Tract 4364.02, Alameda County, California",Alameda,2618,994,904,90
"Census Tract 4211, Alameda County, California",Alameda,1992,842,765,77
"Census Tract 4505.02, Alameda County, California",Alameda,4185,1495,1357,138
"Census Tract 4515.05, Alameda County, California",Alameda,3337,1137,1031,106
"Census Tract 4051, Alameda County, California",Alameda,4197,1579,1426,153
"Census Tract 4507.51, Alameda County, California",Alameda,2115,656,592,64
"Census Tract 4212, Alameda County, California",Alameda,3563,1464,1320,144
"Census Tract 4431.02, Alameda County, California",Alameda,4611,1410,1271,139
"Census Tract 4302, Alameda County, California",Alameda,6916,2444,2196,248
"Census Tract 4431.05, Alameda County, California",Alameda,4456,1374,1230,144
"Census Tract 4045.01, Alameda County, California",Alameda,1677,688,612,76
"Census Tract 4301.01, Alameda County, California",Alameda,6523,2202,1957,245
"Census Tract 4301.02, Alameda County, California",Alameda,2285,894,794,100
"Census Tract 4507.01, Alameda County, California",Alameda,8075,2605,2302,303
"Census Tract 4303, Alameda County, California",Alameda,3670,1320,1163,157
"Census Tract 4047, Alameda County, California",Alameda,1954,810,713,97
"Census Tract 4433.01, Alameda County, California",Alameda,4074,1207,1062,145
"Census Tract 4507.44, Alameda County, California",Alameda,4831,1553,1366,187
"Census Tract 4100, Alameda County, California",Alameda,2805,1137,991,146
"Census Tract 4283.02, Alameda County, California",Alameda,7074,2661,2315,346
"Census Tract 4506.03, Alameda County, California",Alameda,4657,1515,1316,199
"Census Tract 4099, Alameda County, California",Alameda,3308,1373,1191,182
"Census Tract 4506.06, Alameda County, California",Alameda,5733,1942,1670,272
"Census Tract 4507.52, Alameda County, California",Alameda,5262,1521,1302,219
"Census Tract 4512.02, Alameda County, California",Alameda,3634,1237,1058,179
"Census Tract 4517.03, Alameda County, California",Alameda,3859,1294,1105,189
"Census Tract 4446.01, Alameda County, California",Alameda,4761,1406,1198,208
"Census Tract 4384, Alameda County, California",Alameda,2331,729,621,108
"Census Tract 4001, Alameda County, California",Alameda,2937,1314,1118,196
"Census Tract 4506.01, Alameda County, California",Alameda,3379,1263,1072,191
"Census Tract 4080, Alameda County, California",Alameda,2671,996,844,152
"Census Tract 4415.01, Alameda County, California",Alameda,6068,1718,1454,264
"Census Tract 4045.02, Alameda County, California",Alameda,5784,2443,2062,381
"Census Tract 4371.01, Alameda County, California",Alameda,6448,1812,1518,294
"Census Tract 4334, Alameda County, California",Alameda,6305,2236,1867,369
"Census Tract 4421, Alameda County, California",Alameda,5166,1628,1359,269
"Census Tract 4374, Alameda County, California",Alameda,3408,925,772,153
"Census Tract 4306, Alameda County, California",Alameda,5887,2101,1753,348
"Census Tract 4359, Alameda County, California",Alameda,5073,1639,1366,273
"Census Tract 4422, Alameda County, California",Alameda,6875,2108,1754,354
"Census Tract 4507.42, Alameda County, California",Alameda,4576,1781,1480,301
"Census Tract 4262, Alameda County, California",Alameda,4745,1685,1400,285
"Census Tract 4433.22, Alameda County, California",Alameda,2985,923,765,158
"Census Tract 4215, Alameda County, California",Alameda,3640,1555,1282,273
"Census Tract 4042, Alameda County, California",Alameda,3483,1367,1127,240
"Census Tract 4214, Alameda County, California",Alameda,1593,663,546,117
"Census Tract 4335, Alameda County, California",Alameda,4352,1374,1131,243
"Census Tract 4360, Alameda County, California",Alameda,4557,1436,1182,254
"Census Tract 4044, Alameda County, California",Alameda,5314,2279,1873,406
"Census Tract 4213, Alameda County, California",Alameda,3844,1672,1367,305
"Census Tract 4403.33, Alameda County, California",Alameda,2839,799,650,149
"Census Tract 4382.01, Alameda County, California",Alameda,4540,1195,971,224
"Census Tract 4328, Alameda County, California",Alameda,3729,1425,1155,270
"Census Tract 4403.34, Alameda County, California",Alameda,4016,1045,847,198
"Census Tract 4043, Alameda County, California",Alameda,3218,1337,1081,256
"Census Tract 4441, Alameda County, California",Alameda,7280,2424,1956,468
"Census Tract 4081, Alameda County, California",Alameda,5991,2543,2046,497
"Census Tract 4415.21, Alameda County, California",Alameda,5869,1759,1415,344
"Census Tract 4403.05, Alameda County, California",Alameda,3883,1000,804,196
"Census Tract 4416.01, Alameda County, California",Alameda,4561,1408,1128,280
"Census Tract 4506.05, Alameda County, California",Alameda,3685,1361,1090,271
"Census Tract 4333, Alameda County, California",Alameda,6834,2155,1718,437
"Census Tract 4415.22, Alameda County, California",Alameda,4980,1419,1129,290
"Census Tract 4382.04, Alameda County, California",Alameda,5368,1828,1446,382
"Census Tract 4428, Alameda County, California",Alameda,2816,909,718,191
"Census Tract 4511.01, Alameda County, California",Alameda,7081,2324,1829,495
"Census Tract 4352, Alameda County, California",Alameda,4140,1375,1079,296
"Census Tract 4517.01, Alameda County, California",Alameda,3102,1026,803,223
"Census Tract 4513, Alameda County, California",Alameda,6560,2357,1843,514
"Census Tract 4238, Alameda County, California",Alameda,2925,1248,975,273
"Census Tract 4382.03, Alameda County, California",Alameda,3920,1200,937,263
"Census Tract 4330, Alameda County, California",Alameda,3832,1412,1102,310
"Census Tract 4506.04, Alameda County, California",Alameda,4796,1670,1302,368
"Census Tract 4515.04, Alameda County, California",Alameda,1509,583,453,130
"Census Tract 4283.01, Alameda County, California",Alameda,6526,2437,1887,550
"Census Tract 4430.01, Alameda County, California",Alameda,2917,795,615,180
"Census Tract 4370, Alameda County, California",Alameda,3473,1196,923,273
"Census Tract 4307, Alameda County, California",Alameda,3814,1342,1033,309
"Census Tract 4427, Alameda County, California",Alameda,2873,1046,802,244
"Census Tract 4430.02, Alameda County, California",Alameda,5918,1820,1395,425
"Census Tract 4514.03, Alameda County, California",Alameda,2220,758,578,180
"Census Tract 4358, Alameda County, California",Alameda,5382,1617,1233,384
"Census Tract 4383, Alameda County, California",Alameda,3731,877,667,210
"Census Tract 4442, Alameda County, California",Alameda,6499,1927,1463,464
"Census Tract 4505.01, Alameda County, California",Alameda,3129,1242,942,300
"Census Tract 4411, Alameda County, California",Alameda,4308,1635,1230,405
"Census Tract 4206, Alameda County, California",Alameda,3283,1283,965,318
"Census Tract 4443.01, Alameda County, California",Alameda,3855,1135,851,284
"Census Tract 4351.02, Alameda County, California",Alameda,5179,1568,1171,397
"Census Tract 4403.07, Alameda County, California",Alameda,4219,1555,1159,396
"Census Tract 4446.02, Alameda County, California",Alameda,4014,1514,1128,386
"Census Tract 4077, Alameda County, California",Alameda,4109,1714,1275,439
"Census Tract 4381, Alameda County, California",Alameda,7675,2125,1579,546
"Census Tract 4517.04, Alameda County, California",Alameda,4449,1610,1191,419
"Census Tract 4414.02, Alameda County, California",Alameda,5233,1694,1253,441
"Census Tract 4403.06, Alameda County, California",Alameda,3841,987,727,260
"Census Tract 4378, Alameda County, California",Alameda,4621,1307,962,345
"Census Tract 4216, Alameda County, California",Alameda,3558,1589,1169,420
"Census Tract 4321, Alameda County, California",Alameda,3770,1439,1058,381
"Census Tract 4507.46, Alameda County, California",Alameda,3152,1225,900,325
"Census Tract 4201, Alameda County, California",Alameda,2355,888,647,241
"Census Tract 4403.01, Alameda County, California",Alameda,7312,2106,1534,572
"Census Tract 4504, Alameda County, California",Alameda,5968,2041,1478,563
"Census Tract 4079, Alameda County, California",Alameda,2706,1105,800,305
"Census Tract 4506.02, Alameda County, California",Alameda,8722,3190,2304,886
"Census Tract 4271, Alameda County, California",Alameda,3646,1391,1004,387
"Census Tract 4426.01, Alameda County, California",Alameda,3844,1263,910,353
"Census Tract 4415.03, Alameda County, California",Alameda,5389,1819,1301,518
"Census Tract 4429, Alameda County, California",Alameda,7194,2303,1634,669
"Census Tract 4327, Alameda County, California",Alameda,2478,1013,714,299
"Census Tract 4503, Alameda County, California",Alameda,4551,1547,1090,457
"Census Tract 4507.45, Alameda County, California",Alameda,5956,1995,1405,590
"Census Tract 4516.01, Alameda County, California",Alameda,4617,1757,1235,522
"Census Tract 9820, Alameda County, California",Alameda,71,33,23,10
"Census Tract 4413.02, Alameda County, California",Alameda,5553,1814,1259,555
"Census Tract 4512.01, Alameda County, California",Alameda,6595,2491,1723,768
"Census Tract 4068, Alameda County, California",Alameda,3428,1370,931,439
"Census Tract 4067, Alameda County, California",Alameda,5048,2218,1500,718
"Census Tract 4218, Alameda County, California",Alameda,2007,886,599,287
"Census Tract 4078, Alameda County, California",Alameda,2425,715,483,232
"Census Tract 4357, Alameda County, California",Alameda,4594,1461,981,480
"Census Tract 4424, Alameda County, California",Alameda,6253,1912,1282,630
"Census Tract 4083, Alameda County, California",Alameda,4167,1653,1105,548
"Census Tract 4226, Alameda County, California",Alameda,1215,12,8,4
"Census Tract 4515.03, Alameda County, California",Alameda,5660,2054,1361,693
"Census Tract 4380, Alameda County, California",Alameda,3283,1089,719,370
"Census Tract 4308, Alameda County, California",Alameda,5394,2097,1383,714
"Census Tract 4431.04, Alameda County, California",Alameda,5558,1710,1125,585
"Census Tract 4515.01, Alameda County, California",Alameda,4668,1752,1145,607
"Census Tract 4414.01, Alameda County, California",Alameda,6931,2271,1470,801
"Census Tract 4412, Alameda County, California",Alameda,6816,2496,1601,895
"Census Tract 4098, Alameda County, California",Alameda,2887,1121,712,409
"Census Tract 4219, Alameda County, California",Alameda,3632,1689,1070,619
"Census Tract 4403.04, Alameda County, California",Alameda,4674,1283,812,471
"Census Tract 4091, Alameda County, California",Alameda,2255,601,378,223
"Census Tract 4104, Alameda County, California",Alameda,3792,1235,773,462
"Census Tract 4050, Alameda County, California",Alameda,3136,1458,907,551
"Census Tract 4331.02, Alameda County, California",Alameda,3989,1333,829,504
"Census Tract 4323, Alameda County, California",Alameda,4656,1620,1004,616
"Census Tract 4101, Alameda County, California",Alameda,2406,899,555,344
"Census Tract 4415.24, Alameda County, California",Alameda,4010,1298,799,499
"Census Tract 4425, Alameda County, California",Alameda,7371,2167,1332,835
"Census Tract 4514.01, Alameda County, California",Alameda,5850,2256,1382,874
"Census Tract 4372, Alameda County, California",Alameda,6755,2327,1424,903
"Census Tract 4418, Alameda County, California",Alameda,6786,2310,1406,904
"Census Tract 4002, Alameda County, California",Alameda,1974,856,508,348
"Census Tract 4419.24, Alameda County, California",Alameda,7301,2569,1521,1048
"Census Tract 4417, Alameda County, California",Alameda,7436,2585,1530,1055
"Census Tract 4403.35, Alameda County, California",Alameda,6496,2172,1276,896
"Census Tract 4361, Alameda County, California",Alameda,5261,1733,1018,715
"Census Tract 4336, Alameda County, California",Alameda,5978,2054,1205,849
"Census Tract 4501.02, Alameda County, California",Alameda,9434,1251,733,518
"Census Tract 4444, Alameda County, California",Alameda,5114,1431,828,603
"Census Tract 4069, Alameda County, California",Alameda,3719,1488,859,629
"Census Tract 4090, Alameda County, California",Alameda,3552,984,567,417
"Census Tract 4282, Alameda County, California",Alameda,6259,2615,1502,1113
"Census Tract 4376, Alameda County, California",Alameda,3217,894,510,384
"Census Tract 4507.41, Alameda County, California",Alameda,4768,1764,1006,758
"Census Tract 4092, Alameda County, California",Alameda,3152,838,476,362
"Census Tract 4403.36, Alameda County, California",Alameda,4459,1402,794,608
"Census Tract 4305, Alameda County, California",Alameda,6049,2020,1141,879
"Census Tract 4325.01, Alameda County, California",Alameda,4839,1462,824,638
"Census Tract 4325.02, Alameda County, California",Alameda,4485,1398,787,611
"Census Tract 4049, Alameda County, California",Alameda,4129,1885,1061,824
"Census Tract 4416.02, Alameda County, California",Alameda,6802,2219,1244,975
"Census Tract 4516.02, Alameda County, California",Alameda,6224,2727,1521,1206
"Census Tract 4426.02, Alameda County, California",Alameda,5074,1659,919,740
"Census Tract 4373, Alameda County, California",Alameda,3111,883,488,395
"Census Tract 4423.01, Alameda County, California",Alameda,4388,1418,770,648
"Census Tract 4364.01, Alameda County, California",Alameda,7042,2734,1476,1258
"Census Tract 4312, Alameda County, California",Alameda,5627,2531,1366,1165
"Census Tract 4071.02, Alameda County, California",Alameda,4351,1263,661,602
"Census Tract 4203, Alameda County, California",Alameda,4571,1987,1037,950
"Census Tract 4367, Alameda County, California",Alameda,3284,1004,521,483
"Census Tract 4402, Alameda County, California",Alameda,5989,1434,739,695
"Census Tract 4286, Alameda County, California",Alameda,3271,1547,795,752
"Census Tract 4403.08, Alameda County, California",Alameda,5883,1951,999,952
"Census Tract 4443.02, Alameda County, California",Alameda,4354,1198,612,586
"Census Tract 4251.01, Alameda County, California",Alameda,1596,1138,577,561
"Census Tract 4433.21, Alameda County, California",Alameda,3142,1155,585,570
"Census Tract 4281, Alameda County, California",Alameda,4651,1950,984,966
"Census Tract 4371.02, Alameda County, California",Alameda,4251,1387,691,696
"Census Tract 4507.50, Alameda County, California",Alameda,3618,1697,845,852
"Census Tract 4233, Alameda County, California",Alameda,3647,1621,801,820
"Census Tract 4048, Alameda County, California",Alameda,2684,1216,598,618
"Census Tract 4403.31, Alameda County, California",Alameda,3205,899,442,457
"Census Tract 4415.23, Alameda County, California",Alameda,4077,1381,672,709
"Census Tract 4205, Alameda County, California",Alameda,2308,932,452,480
"Census Tract 4324, Alameda County, California",Alameda,5814,1822,882,940
"Census Tract 4082, Alameda County, California",Alameda,4054,1638,792,846
"Census Tract 4401, Alameda County, California",Alameda,2310,875,421,454
"Census Tract 4076, Alameda County, California",Alameda,6027,2022,968,1054
"Census Tract 4413.01, Alameda County, California",Alameda,3179,1163,552,611
"Census Tract 4273, Alameda County, California",Alameda,4896,2082,985,1097
"Census Tract 4368, Alameda County, California",Alameda,4027,1318,623,695
"Census Tract 4338, Alameda County, California",Alameda,7369,2426,1141,1285
"Census Tract 4102, Alameda County, California",Alameda,3062,1027,482,545
"Census Tract 4445, Alameda County, California",Alameda,6696,1937,906,1031
"Census Tract 4064, Alameda County, California",Alameda,2145,710,332,378
"Census Tract 4085, Alameda County, California",Alameda,4972,1476,684,792
"Census Tract 4515.06, Alameda County, California",Alameda,3138,1073,495,578
"Census Tract 4322, Alameda County, California",Alameda,4080,1681,772,909
"Census Tract 4514.04, Alameda County, California",Alameda,6610,2063,940,1123
"Census Tract 4017, Alameda County, California",Alameda,2667,1033,461,572
"Census Tract 9832, Alameda County, California",Alameda,540,287,127,160
"Census Tract 4221, Alameda County, California",Alameda,2685,1114,491,623
"Census Tract 4084, Alameda County, California",Alameda,3323,1080,469,611
"Census Tract 4222, Alameda County, California",Alameda,3144,1527,659,868
"Census Tract 4086, Alameda County, California",Alameda,5492,1702,733,969
"Census Tract 4003, Alameda County, California",Alameda,4865,2418,1037,1381
"Census Tract 4369, Alameda County, California",Alameda,6724,1820,779,1041
"Census Tract 4087, Alameda County, California",Alameda,7207,2259,964,1295
"Census Tract 4332, Alameda County, California",Alameda,6897,2730,1163,1567
"Census Tract 4093, Alameda County, California",Alameda,5229,1463,621,842
"Census Tract 4379, Alameda County, California",Alameda,2338,666,281,385
"Census Tract 4066.01, Alameda County, California",Alameda,4596,1680,707,973
"Census Tract 4004, Alameda County, California",Alameda,3703,1779,745,1034
"Census Tract 4094, Alameda County, California",Alameda,4306,1094,453,641
"Census Tract 4231, Alameda County, California",Alameda,3964,1848,764,1084
"Census Tract 4287, Alameda County, California",Alameda,4119,1176,486,690
"Census Tract 4337, Alameda County, California",Alameda,3182,1004,410,594
"Census Tract 4103, Alameda County, California",Alameda,3536,892,364,528
"Census Tract 4070, Alameda County, California",Alameda,5885,2005,817,1188
"Census Tract 4251.03, Alameda County, California",Alameda,2502,1276,514,762
"Census Tract 4240.02, Alameda County, California",Alameda,2172,907,365,542
"Census Tract 4353, Alameda County, California",Alameda,4479,1609,647,962
"Census Tract 4220, Alameda County, California",Alameda,1756,667,267,400
"Census Tract 4230, Alameda County, California",Alameda,4396,2071,828,1243
"Census Tract 4095, Alameda County, California",Alameda,3122,802,320,482
"Census Tract 4007, Alameda County, California",Alameda,4206,1755,699,1056
"Census Tract 4272, Alameda County, California",Alameda,4107,1595,625,970
"Census Tract 4236.01, Alameda County, California",Alameda,2642,1190,466,724
"Census Tract 4239.02, Alameda County, California",Alameda,1552,751,293,458
"Census Tract 4058, Alameda County, California",Alameda,3965,1223,476,747
"Census Tract 4006, Alameda County, California",Alameda,1571,690,268,422
"Census Tract 4366.01, Alameda County, California",Alameda,6091,1790,693,1097
"Census Tract 4202, Alameda County, California",Alameda,2898,1217,471,746
"Census Tract 4012, Alameda County, California",Alameda,2416,1216,470,746
"Census Tract 4278, Alameda County, California",Alameda,4640,1992,768,1224
"Census Tract 4005, Alameda County, California",Alameda,3517,1578,608,970
"Census Tract 4310, Alameda County, California",Alameda,2714,1158,438,720
"Census Tract 4063, Alameda County, California",Alameda,4113,1211,457,754
"Census Tract 4038, Alameda County, California",Alameda,3461,1858,693,1165
"Census Tract 4237, Alameda County, California",Alameda,3633,1395,516,879
"Census Tract 4041.01, Alameda County, California",Alameda,2929,1644,607,1037
"Census Tract 4009, Alameda County, California",Alameda,2302,1019,372,647
"Census Tract 4015, Alameda County, California",Alameda,2630,940,343,597
"Census Tract 4279, Alameda County, California",Alameda,4567,2090,755,1335
"Census Tract 4234, Alameda County, California",Alameda,4685,1996,717,1279
"Census Tract 4239.01, Alameda County, California",Alameda,2020,883,317,566
"Census Tract 4096, Alameda County, California",Alameda,5063,1402,503,899
"Census Tract 4223, Alameda County, California",Alameda,3387,1661,595,1066
"Census Tract 4097, Alameda County, California",Alameda,4696,1437,514,923
"Census Tract 4507.43, Alameda County, California",Alameda,4734,1915,676,1239
"Census Tract 4340, Alameda County, California",Alameda,4884,1676,584,1092
"Census Tract 4311, Alameda County, California",Alameda,3225,1295,449,846
"Census Tract 4031, Alameda County, California",Alameda,2238,701,243,458
"Census Tract 4039, Alameda County, California",Alameda,3584,2087,721,1366
"Census Tract 4217, Alameda County, California",Alameda,3198,1574,542,1032
"Census Tract 4502, Alameda County, California",Alameda,4067,1923,662,1261
"Census Tract 4277, Alameda County, California",Alameda,4866,2253,771,1482
"Census Tract 4419.21, Alameda County, California",Alameda,3663,1247,422,825
"Census Tract 4008, Alameda County, California",Alameda,3594,1567,529,1038
"Census Tract 4022, Alameda County, California",Alameda,2385,849,285,564
"Census Tract 4285, Alameda County, California",Alameda,3183,1431,478,953
"Census Tract 4501.01, Alameda County, California",Alameda,4349,1822,606,1216
"Census Tract 4356.02, Alameda County, California",Alameda,5329,1648,547,1101
"Census Tract 4232, Alameda County, California",Alameda,2794,1077,349,728
"Census Tract 4251.04, Alameda County, California",Alameda,3175,1639,530,1109
"Census Tract 4331.04, Alameda County, California",Alameda,3760,1684,541,1143
"Census Tract 4059.02, Alameda County, California",Alameda,3035,891,282,609
"Census Tract 4065, Alameda County, California",Alameda,5930,1854,586,1268
"Census Tract 4061, Alameda County, California",Alameda,4381,1462,462,1000
"Census Tract 4355, Alameda County, California",Alameda,3725,1398,438,960
"Census Tract 4284, Alameda County, California",Alameda,4357,1862,582,1280
"Census Tract 4419.27, Alameda County, California",Alameda,4103,1723,536,1187
"Census Tract 4057, Alameda County, California",Alameda,3243,1279,394,885
"Census Tract 4010, Alameda County, California",Alameda,5678,2354,719,1635
"Census Tract 4351.04, Alameda County, California",Alameda,5216,1923,582,1341
"Census Tract 4071.01, Alameda County, California",Alameda,3414,1002,303,699
"Census Tract 4074, Alameda County, California",Alameda,3954,1081,326,755
"Census Tract 4326, Alameda County, California",Alameda,6842,2867,864,2003
"Census Tract 4073, Alameda County, California",Alameda,2598,738,221,517
"Census Tract 4066.02, Alameda County, California",Alameda,2493,881,262,619
"Census Tract 4506.07, Alameda County, California",Alameda,5251,2236,627,1609
"Census Tract 4052, Alameda County, California",Alameda,4597,2398,671,1727
"Census Tract 4040, Alameda County, California",Alameda,2819,1702,476,1226
"Census Tract 4089, Alameda County, California",Alameda,3414,960,268,692
"Census Tract 4354, Alameda County, California",Alameda,4503,1934,537,1397
"Census Tract 4363, Alameda County, California",Alameda,7129,2152,596,1556
"Census Tract 4375, Alameda County, California",Alameda,4528,1128,311,817
"Census Tract 4030, Alameda County, California",Alameda,2788,1500,411,1089
"Census Tract 4356.01, Alameda County, California",Alameda,4902,1492,406,1086
"Census Tract 4235, Alameda County, California",Alameda,3118,1479,397,1082
"Census Tract 4075, Alameda County, California",Alameda,3931,1196,320,876
"Census Tract 4059.01, Alameda County, California",Alameda,3910,1064,277,787
"Census Tract 4088, Alameda County, California",Alameda,5547,1691,439,1252
"Census Tract 4035.02, Alameda County, California",Alameda,1991,1171,304,867
"Census Tract 4240.01, Alameda County, California",Alameda,3716,1420,368,1052
"Census Tract 4056, Alameda County, California",Alameda,3137,1353,350,1003
"Census Tract 4423.02, Alameda County, California",Alameda,4788,1868,469,1399
"Census Tract 4072, Alameda County, California",Alameda,6746,1851,464,1387
"Census Tract 4033, Alameda County, California",Alameda,4054,2054,505,1549
"Census Tract 4055, Alameda County, California",Alameda,3643,1485,357,1128
"Census Tract 4251.02, Alameda County, California",Alameda,2807,1641,392,1249
"Census Tract 4366.02, Alameda County, California",Alameda,4571,1599,377,1222
"Census Tract 4014, Alameda County, California",Alameda,4314,1396,328,1068
"Census Tract 4365, Alameda County, California",Alameda,4583,1699,395,1304
"Census Tract 4011, Alameda County, California",Alameda,4156,2007,453,1554
"Census Tract 4018, Alameda County, California",Alameda,1703,637,140,497
"Census Tract 4062.01, Alameda County, California",Alameda,4649,1300,285,1015
"Census Tract 4331.03, Alameda County, California",Alameda,3530,1442,314,1128
"Census Tract 4419.26, Alameda County, California",Alameda,4080,1376,290,1086
"Census Tract 4276, Alameda County, California",Alameda,4722,1712,350,1362
"Census Tract 4309, Alameda County, California",Alameda,4681,1785,364,1421
"Census Tract 4377.01, Alameda County, California",Alameda,3649,1005,198,807
"Census Tract 4024, Alameda County, California",Alameda,2351,1028,201,827
"Census Tract 4037.02, Alameda County, California",Alameda,1724,1093,212,881
"Census Tract 4016, Alameda County, California",Alameda,2163,765,144,621
"Census Tract 4027, Alameda County, California",Alameda,1569,604,113,491
"Census Tract 4036, Alameda County, California",Alameda,4482,2542,455,2087
"Census Tract 4225, Alameda County, California",Alameda,4658,1575,278,1297
"Census Tract 4339, Alameda County, California",Alameda,6599,2201,386,1815
"Census Tract 4026, Alameda County, California",Alameda,1151,618,104,514
"Census Tract 4419.25, Alameda County, California",Alameda,6159,2772,462,2310
"Census Tract 4362, Alameda County, California",Alameda,3827,1216,186,1030
"Census Tract 4280, Alameda County, California",Alameda,2928,1329,201,1128
"Census Tract 4025, Alameda County, California",Alameda,1784,673,99,574
"Census Tract 4041.02, Alameda County, California",Alameda,2283,1544,222,1322
"Census Tract 4062.02, Alameda County, California",Alameda,4718,1294,179,1115
"Census Tract 4060, Alameda County, California",Alameda,3450,1519,210,1309
"Census Tract 4105, Alameda County, California",Alameda,2193,848,113,735
"Census Tract 4054.02, Alameda County, California",Alameda,3114,1098,145,953
"Census Tract 4037.01, Alameda County, California",Alameda,2587,1686,222,1464
"Census Tract 4034, Alameda County, California",Alameda,4146,2713,354,2359
"Census Tract 4054.01, Alameda County, California",Alameda,3957,1570,201,1369
"Census Tract 4236.02, Alameda County, California",Alameda,5659,2512,309,2203
"Census Tract 4035.01, Alameda County, California",Alameda,4374,2547,308,2239
"Census Tract 4224, Alameda County, California",Alameda,4196,2198,256,1942
"Census Tract 4053.01, Alameda County, California",Alameda,2603,1477,169,1308
"Census Tract 4227, Alameda County, California",Alameda,4885,1303,124,1179
"Census Tract 4013, Alameda County, California",Alameda,3528,1632,140,1492
"Census Tract 4377.02, Alameda County, California",Alameda,4256,1030,72,958
"Census Tract 4419.23, Alameda County, California",Alameda,5605,2037,127,1910
"Census Tract 4053.02, Alameda County, California",Alameda,2530,1406,76,1330
"Census Tract 4028, Alameda County, California",Alameda,3345,2025,103,1922
"Census Tract 9819, Alameda County, California",Alameda,38,22,1,21
"Census Tract 4229, Alameda County, California",Alameda,4336,2079,29,2050
"Census Tract 4228, Alameda County, California",Alameda,8368,1561,14,1547
"Census Tract 4029, Alameda County, California",Alameda,1434,921,6,915
"Census Tract 4204, Alameda County, California",Alameda,3124,1094,2,1092
"Census Tract 9900, Contra Costa County, California",Contra Costa,0,0,0,0
"Census Tract 3511.03, Contra Costa County, California",Contra Costa,1846,1298,1237,61
"Census Tract 3512, Contra Costa County, California",Contra Costa,5812,2045,1923,122
"Census Tract 3551.17, Contra Costa County, California",Contra Costa,8379,2165,2026,139
"Census Tract 3511.01, Contra Costa County, California",Contra Costa,2594,1899,1774,125
"Census Tract 3553.02, Contra Costa County, California",Contra Costa,3484,1205,1124,81
"Census Tract 3461.02, Contra Costa County, California",Contra Costa,5650,1974,1839,135
"Census Tract 3551.16, Contra Costa County, California",Contra Costa,5664,1540,1432,108
"Census Tract 3521.02, Contra Costa County, California",Contra Costa,5586,1813,1684,129
"Census Tract 3521.01, Contra Costa County, California",Contra Costa,3141,819,755,64
"Census Tract 3462.03, Contra Costa County, California",Contra Costa,3838,1418,1306,112
"Census Tract 3530.02, Contra Costa County, California",Contra Costa,4078,1476,1358,118
"Census Tract 3452.04, Contra Costa County, California",Contra Costa,3586,1244,1142,102
"Census Tract 3601.02, Contra Costa County, California",Contra Costa,4326,1489,1352,137
"Census Tract 3451.13, Contra Costa County, California",Contra Costa,4337,1469,1333,136
"Census Tract 3511.02, Contra Costa County, California",Contra Costa,3635,2740,2486,254
"Census Tract 3551.12, Contra Costa County, California",Contra Costa,5563,2011,1824,187
"Census Tract 3553.06, Contra Costa County, California",Contra Costa,4922,1793,1626,167
"Census Tract 3462.04, Contra Costa County, California",Contra Costa,7278,2491,2245,246
"Census Tract 3480, Contra Costa County, California",Contra Costa,4587,1646,1482,164
"Census Tract 3551.13, Contra Costa County, California",Contra Costa,4985,1665,1498,167
"Census Tract 3461.01, Contra Costa County, California",Contra Costa,3433,1291,1161,130
"Census Tract 3383.01, Contra Costa County, California",Contra Costa,2922,1091,979,112
"Census Tract 3451.14, Contra Costa County, California",Contra Costa,6307,2507,2243,264
"Census Tract 3462.01, Contra Costa County, California",Contra Costa,7181,2597,2316,281
"Census Tract 3540.02, Contra Costa County, California",Contra Costa,6590,2525,2241,284
"Census Tract 3530.01, Contra Costa County, California",Contra Costa,3521,1299,1148,151
"Census Tract 3540.01, Contra Costa County, California",Contra Costa,1859,702,619,83
"Census Tract 3211.02, Contra Costa County, California",Contra Costa,6689,2697,2378,319
"Census Tract 3020.10, Contra Costa County, California",Contra Costa,10039,2971,2610,361
"Census Tract 3470, Contra Costa County, California",Contra Costa,6171,2304,2018,286
"Census Tract 3383.02, Contra Costa County, California",Contra Costa,5807,2140,1868,272
"Census Tract 3851, Contra Costa County, California",Contra Costa,2765,1146,999,147
"Census Tract 3032.05, Contra Costa County, California",Contra Costa,8309,3267,2838,429
"Census Tract 3200.03, Contra Costa County, California",Contra Costa,2805,1019,874,145
"Census Tract 3451.02, Contra Costa County, California",Contra Costa,3895,1284,1101,183
"Census Tract 3840, Contra Costa County, California",Contra Costa,3883,1611,1381,230
"Census Tract 3553.01, Contra Costa County, California",Contra Costa,7833,2746,2345,401
"Census Tract 3551.07, Contra Costa County, California",Contra Costa,5048,1532,1308,224
"Census Tract 3553.04, Contra Costa County, California",Contra Costa,7831,3031,2586,445
"Census Tract 3551.14, Contra Costa County, California",Contra Costa,11035,3388,2888,500
"Census Tract 3382.01, Contra Costa County, California",Contra Costa,3790,1406,1198,208
"Census Tract 3451.16, Contra Costa County, California",Contra Costa,2859,934,795,139
"Census Tract 3592.02, Contra Costa County, California",Contra Costa,6148,2245,1910,335
"Census Tract 3040.04, Contra Costa County, California",Contra Costa,3738,1508,1280,228
"Census Tract 3560.02, Contra Costa County, California",Contra Costa,5375,1954,1654,300
"Census Tract 3920, Contra Costa County, California",Contra Costa,2451,1082,915,167
"Census Tract 3901, Contra Costa County, California",Contra Costa,2229,925,782,143
"Census Tract 3852, Contra Costa County, California",Contra Costa,1320,566,477,89
"Census Tract 3451.15, Contra Costa County, California",Contra Costa,5734,1822,1533,289
"Census Tract 3902, Contra Costa County, California",Contra Costa,1719,772,647,125
"Census Tract 3430.03, Contra Costa County, California",Contra Costa,3843,1466,1221,245
"Census Tract 3340.06, Contra Costa County, California",Contra Costa,4767,1688,1403,285
"Census Tract 3551.09, Contra Costa County, California",Contra Costa,6416,2015,1674,341
"Census Tract 3032.02, Contra Costa County, California",Contra Costa,7080,2088,1727,361
"Census Tract 3080.02, Contra Costa County, California",Contra Costa,4194,1268,1048,220
"Census Tract 3551.08, Contra Costa County, California",Contra Costa,12847,3551,2926,625
"Census Tract 3150, Contra Costa County, California",Contra Costa,3281,1120,922,198
"Census Tract 3522.02, Contra Costa County, California",Contra Costa,2548,1023,841,182
"Census Tract 3381.02, Contra Costa County, California",Contra Costa,3601,1322,1086,236
"Census Tract 3591.05, Contra Costa County, California",Contra Costa,4542,1509,1239,270
"Census Tract 3040.03, Contra Costa County, California",Contra Costa,3433,1409,1152,257
"Census Tract 3260, Contra Costa County, California",Contra Costa,3437,1361,1107,254
"Census Tract 3592.04, Contra Costa County, California",Contra Costa,4702,1463,1189,274
"Census Tract 3910, Contra Costa County, California",Contra Costa,2556,1084,880,204
"Census Tract 3560.01, Contra Costa County, California",Contra Costa,3759,1151,933,218
"Census Tract 3211.03, Contra Costa County, California",Contra Costa,4518,1787,1436,351
"Census Tract 3373, Contra Costa County, California",Contra Costa,6098,2242,1797,445
"Census Tract 3020.06, Contra Costa County, California",Contra Costa,3779,1180,945,235
"Census Tract 3132.03, Contra Costa County, California",Contra Costa,3222,946,757,189
"Census Tract 3451.05, Contra Costa County, California",Contra Costa,6223,2249,1798,451
"Census Tract 3040.05, Contra Costa County, California",Contra Costa,6738,1958,1558,400
"Census Tract 3601.01, Contra Costa County, California",Contra Costa,4576,1675,1327,348
"Census Tract 3620, Contra Costa County, California",Contra Costa,2767,1165,921,244
"Census Tract 3032.03, Contra Costa County, California",Contra Costa,8491,2726,2154,572
"Census Tract 3400.02, Contra Costa County, California",Contra Costa,7000,2919,2304,615
"Census Tract 3591.04, Contra Costa County, California",Contra Costa,1932,889,699,190
"Census Tract 3451.03, Contra Costa County, California",Contra Costa,5062,1883,1480,403
"Census Tract 3332, Contra Costa County, California",Contra Costa,5926,2157,1693,464
"Census Tract 3132.05, Contra Costa County, California",Contra Costa,1724,496,389,107
"Census Tract 3592.03, Contra Costa County, California",Contra Costa,6726,2297,1794,503
"Census Tract 3230, Contra Costa County, California",Contra Costa,4352,1684,1299,385
"Census Tract 3320, Contra Costa County, California",Contra Costa,7534,2737,2107,630
"Census Tract 3040.01, Contra Costa County, California",Contra Costa,3718,1175,904,271
"Census Tract 3060.02, Contra Costa County, California",Contra Costa,2985,1045,803,242
"Census Tract 3551.11, Contra Costa County, California",Contra Costa,6343,1842,1408,434
"Census Tract 3032.01, Contra Costa County, California",Contra Costa,9989,2898,2209,689
"Census Tract 3211.01, Contra Costa County, California",Contra Costa,6549,2486,1888,598
"Census Tract 3342, Contra Costa County, California",Contra Costa,6794,2678,2033,645
"Census Tract 3551.10, Contra Costa County, California",Contra Costa,4197,1181,895,286
"Census Tract 3010, Contra Costa County, California",Contra Costa,3659,1586,1197,389
"Census Tract 3270, Contra Costa County, California",Contra Costa,6695,2668,2012,656
"Census Tract 3072.04, Contra Costa County, California",Contra Costa,4300,1296,976,320
"Census Tract 3020.08, Contra Costa County, California",Contra Costa,7718,2126,1597,529
"Census Tract 3451.08, Contra Costa County, California",Contra Costa,7353,3242,2434,808
"Census Tract 3141.02, Contra Costa County, California",Contra Costa,5923,1667,1244,423
"Census Tract 3331.02, Contra Costa County, California",Contra Costa,3855,1487,1108,379
"Census Tract 3923, Contra Costa County, California",Contra Costa,3102,891,663,228
"Census Tract 3522.01, Contra Costa County, California",Contra Costa,5750,2268,1683,585
"Census Tract 3451.01, Contra Costa County, California",Contra Costa,5730,2023,1500,523
"Census Tract 3300, Contra Costa County, California",Contra Costa,5353,1876,1385,491
"Census Tract 3371, Contra Costa County, California",Contra Costa,3200,1158,853,305
"Census Tract 3220, Contra Costa County, California",Contra Costa,6085,2474,1818,656
"Census Tract 3331.01, Contra Costa County, California",Contra Costa,4091,1437,1052,385
"Census Tract 3020.07, Contra Costa County, California",Contra Costa,6347,1943,1416,527
"Census Tract 3452.03, Contra Costa County, California",Contra Costa,6472,2654,1927,727
"Census Tract 3700, Contra Costa County, California",Contra Costa,2837,1119,812,307
"Census Tract 3032.04, Contra Costa County, California",Contra Costa,4182,1478,1063,415
"Census Tract 3020.09, Contra Costa County, California",Contra Costa,5641,1616,1157,459
"Census Tract 3640.02, Contra Costa County, California",Contra Costa,5518,1798,1275,523
"Census Tract 3080.01, Contra Costa County, California",Contra Costa,7229,2408,1699,709
"Census Tract 3031.02, Contra Costa County, California",Contra Costa,7624,2216,1561,655
"Census Tract 3922, Contra Costa County, California",Contra Costa,10605,3048,2112,936
"Census Tract 3350, Contra Costa County, California",Contra Costa,3358,1218,837,381
"Census Tract 3071.01, Contra Costa County, California",Contra Costa,4166,1472,1008,464
"Census Tract 3200.01, Contra Costa County, California",Contra Costa,3615,1201,822,379
"Census Tract 3250, Contra Costa County, California",Contra Costa,5514,2174,1463,711
"Census Tract 3410, Contra Costa County, California",Contra Costa,4864,2019,1346,673
"Census Tract 3290, Contra Costa County, California",Contra Costa,6309,2227,1483,744
"Census Tract 3040.02, Contra Costa County, California",Contra Costa,1426,449,295,154
"Census Tract 3610, Contra Costa County, California",Contra Costa,4475,1698,1108,590
"Census Tract 3372, Contra Costa County, California",Contra Costa,7183,2959,1923,1036
"Census Tract 3430.02, Contra Costa County, California",Contra Costa,4380,1994,1294,700
"Census Tract 3142, Contra Costa County, California",Contra Costa,6482,1663,1076,587
"Census Tract 3591.02, Contra Costa County, California",Contra Costa,5159,1815,1174,641
"Census Tract 3200.04, Contra Costa County, California",Contra Costa,6216,2490,1606,884
"Census Tract 3131.03, Contra Costa County, California",Contra Costa,7723,2514,1604,910
"Census Tract 3552, Contra Costa County, California",Contra Costa,7444,2213,1381,832
"Census Tract 3591.03, Contra Costa County, California",Contra Costa,5051,1955,1217,738
"Census Tract 3602, Contra Costa County, California",Contra Costa,4626,1750,1089,661
"Census Tract 3031.03, Contra Costa County, California",Contra Costa,10812,3298,2047,1251
"Census Tract 3660.01, Contra Costa County, California",Contra Costa,4307,1216,753,463
"Census Tract 3630, Contra Costa County, California",Contra Costa,7043,2623,1621,1002
"Census Tract 3190, Contra Costa County, California",Contra Costa,7412,2995,1842,1153
"Census Tract 3382.04, Contra Costa County, California",Contra Costa,5662,2771,1686,1085
"Census Tract 3490, Contra Costa County, California",Contra Costa,4686,1906,1157,749
"Census Tract 3310, Contra Costa County, California",Contra Costa,7013,2641,1590,1051
"Census Tract 3720, Contra Costa County, California",Contra Costa,7353,2246,1348,898
"Census Tract 3090, Contra Costa County, California",Contra Costa,2771,1017,609,408
"Census Tract 3020.05, Contra Costa County, California",Contra Costa,6592,2231,1333,898
"Census Tract 3362.01, Contra Costa County, California",Contra Costa,4032,1172,700,472
"Census Tract 3132.06, Contra Costa County, California",Contra Costa,5757,1518,895,623
"Census Tract 3451.11, Contra Costa County, California",Contra Costa,5099,1941,1142,799
"Census Tract 3710, Contra Costa County, California",Contra Costa,5316,1880,1096,784
"Census Tract 3451.12, Contra Costa County, California",Contra Costa,6513,2387,1364,1023
"Census Tract 3830, Contra Costa County, California",Contra Costa,4485,2002,1139,863
"Census Tract 3672, Contra Costa County, California",Contra Costa,5171,1505,855,650
"Census Tract 3132.04, Contra Costa County, California",Contra Costa,5542,1745,989,756
"Census Tract 3060.03, Contra Costa County, California",Contra Costa,4881,1677,944,733
"Census Tract 3780, Contra Costa County, California",Contra Costa,3435,1792,1008,784
"Census Tract 3452.02, Contra Costa County, California",Contra Costa,7816,3243,1813,1430
"Census Tract 3400.01, Contra Costa County, California",Contra Costa,5857,2309,1278,1031
"Census Tract 3690.02, Contra Costa County, California",Contra Costa,2548,990,544,446
"Census Tract 3570, Contra Costa County, California",Contra Costa,3018,1432,783,649
"Census Tract 3730, Contra Costa County, California",Contra Costa,4376,1104,602,502
"Census Tract 3340.01, Contra Costa County, California",Contra Costa,3749,1499,816,683
"Census Tract 3340.04, Contra Costa County, California",Contra Costa,7367,3104,1669,1435
"Census Tract 3430.01, Contra Costa County, California",Contra Costa,4806,2053,1103,950
"Census Tract 3110, Contra Costa County, California",Contra Costa,5001,1416,758,658
"Census Tract 3580, Contra Costa County, California",Contra Costa,5298,1904,1016,888
"Census Tract 3131.02, Contra Costa County, California",Contra Costa,3984,1353,720,633
"Census Tract 3660.02, Contra Costa County, California",Contra Costa,6093,1716,907,809
"Census Tract 3500, Contra Costa County, California",Contra Costa,5512,2435,1283,1152
"Census Tract 3800, Contra Costa County, California",Contra Costa,5706,2606,1355,1251
"Census Tract 3100, Contra Costa County, California",Contra Costa,5641,1613,837,776
"Census Tract 3671, Contra Costa County, California",Contra Costa,5099,1900,978,922
"Census Tract 3740, Contra Costa County, California",Contra Costa,4506,1712,871,841
"Census Tract 3870, Contra Costa County, California",Contra Costa,2532,1133,568,565
"Census Tract 3060.04, Contra Costa County, California",Contra Costa,3324,1138,570,568
"Census Tract 3180, Contra Costa County, California",Contra Costa,3267,1470,734,736
"Census Tract 3880, Contra Costa County, California",Contra Costa,2576,1142,561,581
"Census Tract 3381.01, Contra Costa County, California",Contra Costa,4996,1795,869,926
"Census Tract 3071.02, Contra Costa County, California",Contra Costa,5038,1689,817,872
"Census Tract 3141.04, Contra Costa County, California",Contra Costa,7118,2196,1041,1155
"Census Tract 3141.03, Contra Costa County, California",Contra Costa,5546,1582,747,835
"Census Tract 3212, Contra Costa County, California",Contra Costa,5533,2272,1072,1200
"Census Tract 3072.05, Contra Costa County, California",Contra Costa,6595,2419,1118,1301
"Census Tract 3680.01, Contra Costa County, California",Contra Costa,5327,1310,605,705
"Census Tract 3680.02, Contra Costa County, California",Contra Costa,3404,882,405,477
"Census Tract 3072.01, Contra Costa County, California",Contra Costa,3467,1106,501,605
"Census Tract 3131.01, Contra Costa County, California",Contra Costa,7251,2596,1172,1424
"Census Tract 3810, Contra Costa County, California",Contra Costa,6097,1931,868,1063
"Census Tract 3891, Contra Costa County, California",Contra Costa,2002,871,369,502
"Census Tract 3382.03, Contra Costa County, California",Contra Costa,4564,2484,1042,1442
"Census Tract 3120, Contra Costa County, California",Contra Costa,2292,745,311,434
"Census Tract 3790, Contra Costa County, California",Contra Costa,6117,1772,739,1033
"Census Tract 3650.02, Contra Costa County, California",Contra Costa,5462,1468,588,880
"Census Tract 3770, Contra Costa County, California",Contra Costa,6962,2140,831,1309
"Census Tract 3690.01, Contra Costa County, California",Contra Costa,6246,2281,863,1418
"Census Tract 3820, Contra Costa County, California",Contra Costa,6964,2541,950,1591
"Census Tract 3170, Contra Costa County, California",Contra Costa,2144,995,356,639
"Census Tract 3760, Contra Costa County, California",Contra Costa,5962,1786,614,1172
"Census Tract 3750, Contra Costa County, California",Contra Costa,4389,1106,376,730
"Census Tract 3240.02, Contra Costa County, California",Contra Costa,5141,2384,796,1588
"Census Tract 3860, Contra Costa County, California",Contra Costa,3317,1416,434,982
"Census Tract 3050, Contra Costa County, California",Contra Costa,6620,2245,644,1601
"Census Tract 3390.02, Contra Costa County, California",Contra Costa,5574,3113,892,2221
"Census Tract 3551.15, Contra Costa County, California",Contra Costa,4443,1788,476,1312
"Census Tract 3650.03, Contra Costa County, California",Contra Costa,4924,2274,586,1688
"Census Tract 3240.01, Contra Costa County, California",Contra Costa,4615,2529,560,1969
"Census Tract 3361.02, Contra Costa County, California",Contra Costa,7595,2480,499,1981
"Census Tract 3072.02, Contra Costa County, California",Contra Costa,3933,1348,248,1100
"Census Tract 3361.01, Contra Costa County, California",Contra Costa,4802,1430,241,1189
"Census Tract 3362.02, Contra Costa County, California",Contra Costa,5701,1505,252,1253
"Census Tract 3160, Contra Costa County, California",Contra Costa,1483,458,71,387
"Census Tract 3892, Contra Costa County, California",Contra Costa,1714,771,84,687
"Census Tract 3390.01, Contra Costa County, California",Contra Costa,3362,1841,146,1695
"Census Tract 3280, Contra Costa County, California",Contra Costa,2281,1315,83,1232
"Census Tract 9804.01, San Francisco County, California",San Francisco,0,0,0,0
"Census Tract 9901, San Francisco County, California",San Francisco,0,0,0,0
"Census Tract 309, San Francisco County, California",San Francisco,6581,2345,2094,251
"Census Tract 331, San Francisco County, California",San Francisco,3968,1442,1240,202
"Census Tract 307, San Francisco County, California",San Francisco,6343,2651,2243,408
"Census Tract 306, San Francisco County, California",San Francisco,2221,865,724,141
"Census Tract 310, San Francisco County, California",San Francisco,3494,1271,1060,211
"Census Tract 308, San Francisco County, California",San Francisco,5667,2145,1666,479
"Census Tract 428, San Francisco County, California",San Francisco,2376,934,724,210
"Census Tract 610, San Francisco County, California",San Francisco,3610,1150,867,283
"Census Tract 260.02, San Francisco County, California",San Francisco,3544,955,719,236
"Census Tract 259, San Francisco County, California",San Francisco,4261,1327,995,332
"Census Tract 304, San Francisco County, California",San Francisco,5106,1933,1443,490
"Census Tract 313.01, San Francisco County, California",San Francisco,3826,1261,933,328
"Census Tract 303.02, San Francisco County, California",San Francisco,3549,1374,1012,362
"Census Tract 305, San Francisco County, California",San Francisco,3046,1006,730,276
"Census Tract 256, San Francisco County, California",San Francisco,5618,1558,1120,438
"Census Tract 230.01, San Francisco County, California",San Francisco,5216,1312,939,373
"Census Tract 312.02, San Francisco County, California",San Francisco,3137,837,593,244
"Census Tract 329.02, San Francisco County, California",San Francisco,3831,1313,927,386
"Census Tract 254.02, San Francisco County, California",San Francisco,2912,1060,746,314
"Census Tract 264.02, San Francisco County, California",San Francisco,4118,1108,778,330
"Census Tract 329.01, San Francisco County, California",San Francisco,5021,1700,1166,534
"Census Tract 217, San Francisco County, California",San Francisco,3948,1798,1233,565
"Census Tract 330, San Francisco County, California",San Francisco,7764,2698,1839,859
"Census Tract 230.03, San Francisco County, California",San Francisco,4093,1154,786,368
"Census Tract 251, San Francisco County, California",San Francisco,3077,1269,864,405
"Census Tract 260.03, San Francisco County, California",San Francisco,4908,1314,875,439
"Census Tract 313.02, San Francisco County, California",San Francisco,5495,1777,1178,599
"Census Tract 264.01, San Francisco County, California",San Francisco,4044,1016,664,352
"Census Tract 257.01, San Francisco County, California",San Francisco,4788,1331,867,464
"Census Tract 314, San Francisco County, California",San Francisco,6676,1791,1159,632
"Census Tract 263.02, San Francisco County, California",San Francisco,4992,1448,934,514
"Census Tract 9806, San Francisco County, California",San Francisco,467,154,99,55
"Census Tract 263.03, San Francisco County, California",San Francisco,4551,1233,792,441
"Census Tract 311, San Francisco County, California",San Francisco,6193,2462,1569,893
"Census Tract 353, San Francisco County, California",San Francisco,7226,2458,1565,893
"Census Tract 233, San Francisco County, California",San Francisco,2624,620,394,226
"Census Tract 262, San Francisco County, California",San Francisco,7564,1907,1188,719
"Census Tract 255, San Francisco County, California",San Francisco,8471,2469,1526,943
"Census Tract 354, San Francisco County, California",San Francisco,6691,2377,1468,909
"Census Tract 327, San Francisco County, California",San Francisco,6572,2391,1457,934
"Census Tract 216, San Francisco County, California",San Francisco,3836,2026,1219,807
"Census Tract 352.01, San Francisco County, California",San Francisco,5300,1865,1122,743
"Census Tract 264.03, San Francisco County, California",San Francisco,4140,1062,638,424
"Census Tract 218, San Francisco County, California",San Francisco,3840,1768,1062,706
"Census Tract 263.01, San Francisco County, California",San Francisco,4875,1273,760,513
"Census Tract 260.04, San Francisco County, California",San Francisco,4315,1144,678,466
"Census Tract 252, San Francisco County, California",San Francisco,5369,2125,1258,867
"Census Tract 328.02, San Francisco County, California",San Francisco,4047,1443,854,589
"Census Tract 351, San Francisco County, California",San Francisco,7842,2718,1593,1125
"Census Tract 9802, San Francisco County, California",San Francisco,320,62,36,26
"Census Tract 261, San Francisco County, California",San Francisco,6810,1877,1084,793
"Census Tract 258, San Francisco County, California",San Francisco,1960,572,328,244
"Census Tract 312.01, San Francisco County, California",San Francisco,6167,1740,975,765
"Census Tract 328.01, San Francisco County, California",San Francisco,4238,1437,801,636
"Census Tract 213, San Francisco County, California",San Francisco,2474,1171,637,534
"Census Tract 232, San Francisco County, California",San Francisco,4582,1228,666,562
"Census Tract 227.04, San Francisco County, California",San Francisco,3122,1611,866,745
"Census Tract 303.01, San Francisco County, California",San Francisco,5658,2362,1263,1099
"Census Tract 212, San Francisco County, California",San Francisco,2779,1396,744,652
"Census Tract 226, San Francisco County, California",San Francisco,1534,815,434,381
"Census Tract 254.03, San Francisco County, California",San Francisco,4267,1436,758,678
"Census Tract 264.04, San Francisco County, California",San Francisco,2851,671,351,320
"Census Tract 257.02, San Francisco County, California",San Francisco,4665,1229,641,588
"Census Tract 260.01, San Francisco County, California",San Francisco,5863,1519,766,753
"Census Tract 326.02, San Francisco County, California",San Francisco,4316,1669,837,832
"Census Tract 170, San Francisco County, California",San Francisco,3689,2125,1053,1072
"Census Tract 479.01, San Francisco County, California",San Francisco,6400,2670,1273,1397
"Census Tract 479.02, San Francisco County, California",San Francisco,3536,1508,700,808
"Census Tract 133, San Francisco County, California",San Francisco,4232,1887,869,1018
"Census Tract 204.01, San Francisco County, California",San Francisco,2846,1591,731,860
"Census Tract 478.01, San Francisco County, California",San Francisco,4005,1634,737,897
"Census Tract 614, San Francisco County, California",San Francisco,5395,2354,1047,1307
"Census Tract 301.02, San Francisco County, California",San Francisco,4838,2203,960,1243
"Census Tract 254.01, San Francisco County, California",San Francisco,3404,1276,555,721
"Census Tract 211, San Francisco County, California",San Francisco,3853,1863,809,1054
"Census Tract 477.02, San Francisco County, California",San Francisco,3824,1554,666,888
"Census Tract 253, San Francisco County, California",San Francisco,4362,1767,752,1015
"Census Tract 215, San Francisco County, California",San Francisco,5096,2449,1027,1422
"Census Tract 214, San Francisco County, California",San Francisco,3264,1619,676,943
"Census Tract 205, San Francisco County, California",San Francisco,2583,1325,548,777
"Census Tract 171.01, San Francisco County, California",San Francisco,3544,1728,710,1018
"Census Tract 476, San Francisco County, California",San Francisco,5137,2173,890,1283
"Census Tract 612, San Francisco County, California",San Francisco,4089,1115,450,665
"Census Tract 234, San Francisco County, California",San Francisco,3660,964,386,578
"Census Tract 180, San Francisco County, California",San Francisco,4221,1499,598,901
"Census Tract 227.02, San Francisco County, California",San Francisco,2060,981,386,595
"Census Tract 132, San Francisco County, California",San Francisco,4162,2260,857,1403
"Census Tract 452, San Francisco County, California",San Francisco,6474,2735,1036,1699
"Census Tract 228.01, San Francisco County, California",San Francisco,5078,1850,694,1156
"Census Tract 615.00, San Francisco County, California",San Francisco,11502,6785,2527,4258
"Census Tract 206, San Francisco County, California",San Francisco,4711,2594,954,1640
"Census Tract 478.02, San Francisco County, California",San Francisco,3656,1497,550,947
"Census Tract 229.03, San Francisco County, California",San Francisco,3384,1118,405,713
"Census Tract 229.02, San Francisco County, California",San Francisco,2617,802,288,514
"Census Tract 171.02, San Francisco County, California",San Francisco,3451,1687,592,1095
"Census Tract 426.02, San Francisco County, California",San Francisco,3243,1411,492,919
"Census Tract 153, San Francisco County, California",San Francisco,2040,957,330,627
"Census Tract 607, San Francisco County, California",San Francisco,9083,4381,1506,2875
"Census Tract 326.01, San Francisco County, California",San Francisco,4416,1728,592,1136
"Census Tract 231.02, San Francisco County, California",San Francisco,3478,1222,417,805
"Census Tract 156, San Francisco County, California",San Francisco,2728,1272,425,847
"Census Tract 477.01, San Francisco County, California",San Francisco,4334,1869,612,1257
"Census Tract 157, San Francisco County, California",San Francisco,7832,2575,840,1735
"Census Tract 134, San Francisco County, California",San Francisco,3599,1979,644,1335
"Census Tract 352.02, San Francisco County, California",San Francisco,4322,1764,556,1208
"Census Tract 128, San Francisco County, California",San Francisco,4106,2363,718,1645
"Census Tract 228.03, San Francisco County, California",San Francisco,4595,1531,463,1068
"Census Tract 154, San Francisco County, California",San Francisco,5621,2839,853,1986
"Census Tract 228.02, San Francisco County, California",San Francisco,2099,593,178,415
"Census Tract 104, San Francisco County, California",San Francisco,4545,2479,738,1741
"Census Tract 167, San Francisco County, California",San Francisco,4652,2277,665,1612
"Census Tract 402, San Francisco County, California",San Francisco,5191,2352,682,1670
"Census Tract 204.02, San Francisco County, California",San Francisco,3997,2409,696,1713
"Census Tract 9805.01, San Francisco County, California",San Francisco,797,223,64,159
"Census Tract 451, San Francisco County, California",San Francisco,4996,2150,616,1534
"Census Tract 169, San Francisco County, California",San Francisco,2924,1589,455,1134
"Census Tract 102, San Francisco County, California",San Francisco,4143,2544,714,1830
"Census Tract 301.01, San Francisco County, California",San Francisco,4233,1997,560,1437
"Census Tract 427, San Francisco County, California",San Francisco,5326,2352,657,1695
"Census Tract 401, San Francisco County, California",San Francisco,4088,1863,512,1351
"Census Tract 203, San Francisco County, California",San Francisco,3034,1661,449,1212
"Census Tract 426.01, San Francisco County, California",San Francisco,3687,1679,449,1230
"Census Tract 127, San Francisco County, California",San Francisco,3492,2098,555,1543
"Census Tract 103, San Francisco County, California",San Francisco,3852,2026,534,1492
"Census Tract 119.01, San Francisco County, California",San Francisco,2408,1395,367,1028
"Census Tract 151, San Francisco County, California",San Francisco,2493,1655,435,1220
"Census Tract 158.01, San Francisco County, California",San Francisco,3594,1635,428,1207
"Census Tract 302.01, San Francisco County, California",San Francisco,3928,1842,482,1360
"Census Tract 178.02, San Francisco County, California",San Francisco,4516,2214,567,1647
"Census Tract 165, San Francisco County, California",San Francisco,5083,2344,596,1748
"Census Tract 130, San Francisco County, California",San Francisco,4044,2409,598,1811
"Census Tract 160, San Francisco County, California",San Francisco,2465,1633,400,1233
"Census Tract 159, San Francisco County, California",San Francisco,4350,2285,556,1729
"Census Tract 126.02, San Francisco County, California",San Francisco,2909,1724,416,1308
"Census Tract 210, San Francisco County, California",San Francisco,4196,2005,476,1529
"Census Tract 112, San Francisco County, California",San Francisco,3286,1858,440,1418
"Census Tract 207, San Francisco County, California",San Francisco,5171,2718,640,2078
"Census Tract 108, San Francisco County, California",San Francisco,4578,2338,546,1792
"Census Tract 131.02, San Francisco County, California",San Francisco,2625,1582,365,1217
"Census Tract 105, San Francisco County, California",San Francisco,2685,1682,384,1298
"Census Tract 135, San Francisco County, California",San Francisco,2556,1622,370,1252
"Census Tract 152, San Francisco County, California",San Francisco,3934,2430,541,1889
"Census Tract 302.02, San Francisco County, California",San Francisco,4313,2084,461,1623
"Census Tract 177, San Francisco County, California",San Francisco,2128,744,164,580
"Census Tract 168.01, San Francisco County, California",San Francisco,3218,1634,329,1305
"Census Tract 109, San Francisco County, California",San Francisco,4320,2628,526,2102
"Census Tract 166, San Francisco County, California",San Francisco,5069,2480,492,1988
"Census Tract 164, San Francisco County, California",San Francisco,3778,1811,355,1456
"Census Tract 229.01, San Francisco County, California",San Francisco,4640,1410,276,1134
"Census Tract 129.01, San Francisco County, California",San Francisco,2557,1562,299,1263
"Census Tract 131.01, San Francisco County, California",San Francisco,3811,2389,457,1932
"Census Tract 126.01, San Francisco County, California",San Francisco,2329,1496,285,1211
"Census Tract 605.02, San Francisco County, California",San Francisco,3216,961,178,783
"Census Tract 201, San Francisco County, California",San Francisco,6172,2948,545,2403
"Census Tract 101, San Francisco County, California",San Francisco,3739,2090,383,1707
"Census Tract 129.02, San Francisco County, California",San Francisco,3376,2023,365,1658
"Census Tract 158.02, San Francisco County, California",San Francisco,2965,1491,267,1224
"Census Tract 9809, San Francisco County, California",San Francisco,350,146,26,120
"Census Tract 168.02, San Francisco County, California",San Francisco,3264,1804,314,1490
"Census Tract 163, San Francisco County, California",San Francisco,4293,2047,354,1693
"Census Tract 208, San Francisco County, California",San Francisco,6577,2543,432,2111
"Census Tract 202, San Francisco County, California",San Francisco,6269,3228,539,2689
"Census Tract 178.01, San Francisco County, California",San Francisco,3499,2198,363,1835
"Census Tract 604, San Francisco County, California",San Francisco,1689,1001,155,846
"Census Tract 110, San Francisco County, California",San Francisco,4827,2475,357,2118
"Census Tract 209, San Francisco County, California",San Francisco,4372,1742,226,1516
"Census Tract 155, San Francisco County, California",San Francisco,3622,2176,264,1912
"Census Tract 113, San Francisco County, California",San Francisco,3143,1527,158,1369
"Census Tract 231.03, San Francisco County, California",San Francisco,3725,1202,120,1082
"Census Tract 162, San Francisco County, California",San Francisco,2541,1594,155,1439
"Census Tract 176.01, San Francisco County, California",San Francisco,7630,4321,407,3914
"Census Tract 106, San Francisco County, California",San Francisco,3894,2015,182,1833
"Census Tract 117, San Francisco County, California",San Francisco,1783,1012,87,925
"Census Tract 111, San Francisco County, California",San Francisco,5164,3073,236,2837
"Census Tract 161, San Francisco County, California",San Francisco,5366,2756,196,2560
"Census Tract 122.01, San Francisco County, California",San Francisco,4567,2667,152,2515
"Census Tract 107, San Francisco County, California",San Francisco,5592,2778,154,2624
"Census Tract 121, San Francisco County, California",San Francisco,3833,2194,99,2095
"Census Tract 119.02, San Francisco County, California",San Francisco,2598,1700,73,1627
"Census Tract 124.02, San Francisco County, California",San Francisco,3974,2254,94,2160
"Census Tract 611, San Francisco County, California",San Francisco,4307,2135,78,2057
"Census Tract 122.02, San Francisco County, California",San Francisco,2986,1514,39,1475
"Census Tract 125.01, San Francisco County, California",San Francisco,5335,2205,55,2150
"Census Tract 118, San Francisco County, California",San Francisco,1500,695,13,682
"Census Tract 601, San Francisco County, California",San Francisco,3235,1110,17,1093
"Census Tract 120, San Francisco County, California",San Francisco,3833,2546,33,2513
"Census Tract 332.01, San Francisco County, California",San Francisco,3683,647,4,643
"Census Tract 123.01, San Francisco County, California",San Francisco,2734,1559,8,1551
"Census Tract 124.01, San Francisco County, California",San Francisco,5075,2698,13,2685
"Census Tract 125.02, San Francisco County, California",San Francisco,3821,2034,4,2030
"Census Tract 123.02, San Francisco County, California",San Francisco,3073,2098,4,2094
"Census Tract 332.03, San Francisco County, California",San Francisco,3472,1478,1,1477
"Census Tract 179.02, San Francisco County, California",San Francisco,2880,656,0,656
"Census Tract 332.04, San Francisco County, California",San Francisco,3821,1598,0,1598
"Census Tract 9803, San Francisco County, California",San Francisco,171,34,0,34
